xxxxxxxx
xx    .x
x..d d x
x .x  .x
xx d dxx
x xd d x
x..  dpx
xxxxxxxx