  xxxxx
xxx   x
x.pd  x
xxx d.x
x.xxd x
x x . xx
xd  dd.x
x   .  x
xxxxxxxx